C 153,204,255

F 128,128,128

NO ./assets/wolf/WSblue.png
SO ./assets/wolf/WSbrick.png
EA ./assets/wolf/WSgrey.png
WE  ./assets/wolf/WSsteel.png


11111111111111111111
11111111111111111111 
100000000011111E0001
10111101111111111101
10111101111101111101
10111101100001111101
10000000000000010001
10111101101101111101
10111101101101111101
10001100000001100001
10101101101101101001
10000000000000000001
11111111111111111111
 1111111111111111111
11111111111111111111
11111111111111111111
