



     C						153, 204	,255


	SO ./assets/Planks.png







	NO	./assets/Coal.png


F  153		    ,76, 0

WE ./assets/Sand.png

EA ./assets/Bricks.png


1111111111111111111111111
1000000000110000000000001
1011000001110000000000001
100100000000000000000000111111111			
111111111011000001110000000000001				
100000000011000001110111111111111				
11110111111111011100000010001
11110111111111011101010010001
11000000110101011100000010001
10000100000000001100000010001
10000000000000001101010010001
1100000111010101111101111001111111111
1000000000000000000011111111111111111
1111S11111110101110111101000111111111
11111 11 1111111 11111111111111111111
