



     C	      				 225	,	123,234


	SO ./assets/south_texture







	NO												./assets/north_texture


F  220		    ,20, 169

WE ./assets/west_texture

EA ./assets/east_texture


1111111111111111111111111
1000000000110000000000001
1011000001110000000000001
1001000000000000000000001
111111111011000001110000000000001
100000000011000001110111111111111
11110111111111011100000010001
11110111111111011101010010001
11000000110101011100000010001
10000000000000001100000010001
10000000000000001101010010001
1100000111010101111101111001111111111111111111111111111111111111111111
11110111 1110101 1011110100011111111111111111111111111111N1111111
11111111 1111111 11111111111111111111111111111111111111111111111
