



     C	      				 225	,	0,0


	SO ./assets/south_texture







	NO	./assets/north_texture


F  220		    ,20, 169

WE ./assets/west_texture

EA ./assets/east_texture



111111111111111111111111111111
100000000000000000000000000001
100000000000000000000000000001
100000000000000000000000000001
100000000000000000000000000001
10000000000N0w000000000000000001
100000000000000000000000000001
111111111111111111111111111111


