C 153,204,255

F 128,128,128

NO ./assets/wolf/WSblue.png
SO ./assets/wolf/WSbrick.png
EA ./assets/wolf/WSgrey.png
WE  ./assets/wolf/WSsteel.png


11111111111111111111
10000000001100000001
10111101111101111101
10111101111101111101
10111101100001111101
10000000000000000001
10111101101101111101
10111101101101111101
10001100000001100001
10101101101101101001
10000000000000N00001
10101101111101111001
10101101111101101001
10000001101100000001
11111111111111111111
