C 153,204,255

F 1280,128,128

NO ./assets/wolf/WSblue.png
SO ./assets/wolf/WSbrick.png
EA ./assets/wolf/WSgrey.png
WE ./assets/wolf/WSgrey.png

11111111111111111111
100000000011000000N1
10111101111101111101111111111111111111111
111111111111111111111111111111111111111111
